20
20
22222222222222222222
20002000000000020002
20300000000000000302
20002000000000020002
22222222200222222222
20000000000000000002
20202020200202020202
20000000000000000002
20202020200202020202
20000000000000000002
20202222200222220202
20202000000000020202
20202022222222020202
20202220000002220202
20200000200200000202
22222222200222222222
20000000000000000002
20000001000000000002
20000000000000000002
22222222222222222222
